[
  {
    "x": 0,
    "y": 0,
    "tiles": [
      [ 6, 3, 1, 1, 0, 2, 1, 3, 8],
      [ 6, 0, 0, 0, 0, 0, 1, 0, 3],
      [ 6, 0, 0, 1, 1, 0, 1, 0, 0],
      [ 6, 0, 0, 0, 0, 0, 0, 0, 12],
      [ 11, 9, 0, 12, 5, 0, 5, 5, 10],
      [ -1, 6, 0, 3, 1, 1, 1, 1, 1]
    ]
  },
  {
    "x": 1,
    "y": 0,
    "tiles": [
      [ 6, 3, 1, 1, 1, 2, 0, 3, 8],
      [ 6, 0, 0, 0, 0, 0, 0, 0, 3],
      [ 0, 0, 0, 0, 1, 0, 0, 0, 0],
      [ 6, 0, 0, 0, 0, 0, 0, 0, 12],
      [ 10, 9, 0, 12, 5, 5, 5, 5, 11],
      [ -1, 6, 0, 3, 1, 1, 1, 1, 1]
    ]
  },
  {
    "x": 0,
    "y": 1,
    "tiles": [
      [ 6, 3, 0, 1, 1, 2, 0, 3, 8],
      [ 6, 0, 0, 0, 0, 0, 0, 0, 3],
      [ 0, 0, 0, 0, 1, 0, 0, 0, 0],
      [ 6, 0, 0, 0, 0, 0, 0, 0, 12],
      [ 10, 9, 0, 12, 5, 5, 5, 5, 11],
      [ -1, 6, 0, 3, 1, 1, 1, 1, 1]
    ]
  }
]