[
  [ 6, 3, 1, 1, 1, 2, 0, 3, 8],
  [ 6, 0, 0, 0, 0, 0, 0, 0, 3],
  [ 6, 0, 0, 0, 0, 0, 0, 0, 0],
  [ 6, 0, 0, 0, 0, 0, 0, 0, 12],
  [ -1, 9, 0, 12, 5, 5, 5, 5, -1],
  [ -1, 6, 0, 3, 1, 1, 1, 1, 1]
]